#............#
#............#
#............#
#............#
#....###!#...#
#..#.........#
#%.......#...#
#######.....%#
#..........###
#............#
#.....#####..#
#............#
#..####.....%#
#@..........%#
##############