#...........................................................
#...........................................................
#...........#...#...........................................
#..##...##......#...#.......................................
#@..............#...#......................................
############################################################