#..........................................................#
#..............................%%..........................#
#.......%%.........%%%...#....####.......................%%#
#...........#...#.......#.#...#..#.............#############
#..##...##......#...#.........#..#............#...........F#
#@..............#...#.........#..............#.............#
###############################!!############..#############
..............................#...............#.............
..............................#..............#..............
..............................################..............