#..............................%%...........................
#.......%%.........%%%...#....####..........................
#...........#...#.......#.#...#..#.............#############
#..##...##......#...#.........#..#............#............#
#@..............#...#.........#..............#.............#
###############################!!############..#############
..............................#...............#.............
..............................#..............#..............
..............................################..............