#...........................................................
#...........................................................
#...........................................................
#...........................................................
#@..........................................................
############################################################